####################
#........##........#
#.####.#.##.#.####.#
#O#  #.#.##.#.#  #O#
#.#  #.#.##.#.#  #.#
#....#.#.##.#.#....#
####.#.#.##.#.#.####
   #.#.#.##.#.#.#
####.#.#.##.#.#.####
#....#.#.##.#.#....#
#.#  #.#.##.#.#  #.#
#O#  #.#.##.#.#  #O#
#.####.#.##.#.####.#
#........P.........#
####################