####################
#......G.......... #
#..####...##...#####
#O#    #..##..#    #
#.#    #..##..#    #
#....#....##....#..#
####.#....##....#.##
   #.#....##....#.# 
####.#....##....#.##
#....#....##....#..#
#.#    #..##..#    #
#O#    #..##..#    #
#..####...##...#####
#..........P...... #
####################
