####################
#O.......G........O#
#..#######..########
#..#     #..#     ##
#..# ### #..# ### ##
#..# # # #..# # # ##
#..# ### #..# ### ##
#..#     #..#     ##
#..#######..########
#.........P........#
###.#######..####.##
#O#.#     #..#   #O#
###.# ### #..# ###.#
#..................#
####################